+-+-+-+-+-+-+-+-+-+-+-+-+-+-+-+-+-+-+-+-+-+-+-+-+-+-+-+-+-+-+
        |   |     |   |   |   |       | |         |   |     |
+-+ +-+ +-+ +-+-+ + + + +-+ + +-+ + + + + +-+ +-+ + + + +-+ +
|   |   |     |   | | |   | |     | |   |   | |   | | | |   |
+ +-+-+-+ + + + +-+ + + + + +-+-+-+ +-+ +-+ +-+ +-+ + + +-+-+
| |   |   | |       | | | |   |     |     |   | |   |   |   |
+ +-+ +-+-+ +-+-+-+-+-+ + +-+-+ +-+-+-+ + +-+ +-+ + +-+-+ + +
| |     |   |   |       |       |       |       | |   |   | |
+ + + + + +-+ + + +-+-+-+-+-+-+-+ +-+-+-+-+-+-+ + +-+ + +-+ +
| | | |   |   | |     |       |   |   |         | | | | |   |
+ + + +-+ + +-+ +-+ +-+ +-+ +-+ +-+ + + +-+-+-+-+ + + + + +-+
|   | |   | | | |     | | |     |   | | |     |   |     |   |
+ + + + +-+ + + +-+-+ + + +-+-+-+-+-+ + + +-+ + +-+-+-+-+ +-+
| | | |   | | | |     | | |   |       | |   |       |   |   |
+ + + + +-+ + + + +-+-+ + + + + +-+-+-+ +-+ +-+ + + + +-+-+ +
| | | |   | |   | | |   | | | | |     |   | |   | | |     | |
+ +-+ +-+ + +-+ + + + +-+ + + + +-+-+ +-+ +-+ +-+-+ + + +-+ +
|   |   | |   | | | |   | | | |     |   |   | | |   | |     |
+-+ +-+ + +-+ + + + +-+ + + + +-+-+ +-+ +-+ + + + +-+ +-+-+-+
|   |   |     | | | |     | |     | |     | | | |   | | |   |
+ +-+ +-+-+-+-+ + + +-+ +-+ +-+-+ + + +-+ + + + + + + + + + +
| | |     |       |     |   |   |   | |   |   |   | | |   | |
+ + +-+-+ +-+-+ +-+-+-+-+ +-+ + +-+-+-+ +-+-+-+-+-+ + +-+ + +
|     | |   |       |   |     |   |         |       | |   | |
+-+-+ + +-+ + +-+-+-+ + +-+-+-+-+ + +-+ +-+-+ +-+-+-+ + +-+ +
|       |   |     |   |   |     |     |     | |         |   |
+ +-+-+-+ +-+-+-+ + +-+-+ +-+ + +-+-+-+-+-+ + +-+-+-+ +-+ +-+
|     |   |   |   | | |   |   | |         |   |       |   | |
+-+-+ + +-+-+ + +-+ + + + + +-+ + +-+-+-+ +-+-+ +-+-+-+ +-+ +
|     |       |     |   |   |   |       |       |            
+-+-+-+-+-+-+-+-+-+-+-+-+-+-+-+-+-+-+-+-+-+-+-+-+-+-+-+-+-+-+
