+-+-+-+-+-+
  |       |
+ + + +-+ +
|   | |   |
+-+-+-+ + +
|       |  
+-+-+-+-+-+
