+-+-+-+-+-+-+-+-+-+-+-+-+-+-+-+-+-+-+-+-+-+-+-+-+-+-+-+-+-+-+-+-+-+-+-+-+-+-+-+-+
          |   |         |     |   |   |       |         |     |   |   |   |   | |
+-+ +-+-+ + + + +-+ +-+ +-+-+ + + +-+ + +-+-+ + +-+-+-+ +-+-+ + + +-+ + + + + + +
|   |       | |   | |   |   | | |     | |     | |     | |   | | |       |   |   |
+ +-+-+-+ +-+ +-+ +-+ +-+ + + + + +-+ + + +-+-+ + +-+ + + + + + +-+-+-+-+-+-+-+ +
| |   |   |     |   | |   | | | | |   | | |     | | |     |   |   |   |       | |
+ + + + +-+-+-+ +-+ + + +-+ + + + +-+-+ + + +-+-+ + +-+ +-+-+-+-+ +-+ + +-+-+ + +
| | |   |   |   |   |   | | | | |   |   |   | |   |   |     |   |   | | |   |   |
+ +-+-+-+ + +-+-+ +-+-+-+ + + +-+-+ + +-+-+-+ + +-+-+ +-+-+ + + +-+ + + +-+ +-+-+
|       | |   |   |     |   | |     | |     | | | |   |     | |   | | |   | |   |
+-+-+ + +-+-+ + +-+ +-+ +-+-+ + +-+-+ + +-+ + + + + +-+ +-+-+ + + + + +-+ + +-+ +
|     |       |     | |   | | |   |     | | |   | |   | |     | |   | | |   |   |
+ +-+-+-+-+-+-+-+-+-+ +-+ + + +-+ + + +-+ + + +-+ +-+ + + +-+-+-+-+-+ + + +-+ +-+
|   |   |           |   |     |   | | |   | |   |       | |     |     |   |   | |
+-+ +-+ + +-+-+-+-+ + + +-+ +-+ +-+-+ + +-+ +-+ +-+-+ +-+ + +-+ + +-+-+ +-+ +-+ +
|   |   |   |   |   | |             | |     | | |   |   | |   |   |   | |     | |
+ +-+ +-+-+ + + + +-+-+-+-+ +-+ +-+ + +-+ +-+ + + +-+-+ + +-+ +-+-+ + + +-+ + + +
|   |       | | | |         |   |   |   |   |   |   |   | | | |   | |   |   |   |
+ + + +-+-+-+ + + + +-+-+-+-+ +-+ +-+-+ +-+-+-+-+-+ + +-+ + + + + + +-+-+ +-+-+-+
| | | |     | | |   |       | |   |   | |   |     | |     |   | |           |   |
+ + + + +-+ + + +-+-+ +-+-+ + + + + + + + + + +-+-+ +-+ +-+ +-+ +-+-+-+ +-+ + + +
| |   |   |   | |     |   |   | | | | |   | |     |     |     |       | |   | | |
+ +-+-+-+ +-+-+ + +-+-+ + +-+-+-+ +-+ +-+-+ +-+-+ +-+-+-+ +-+ +-+-+-+ + +-+-+ + +
| |   | | |   | | |   | |       |   |   |   |   |       | |   |       |     | | |
+ + + + + + + + + + + + +-+-+-+ +-+ +-+ + +-+ + + +-+-+ +-+ +-+ +-+ +-+-+-+ + + +
|   |     | |   |   |   |     | | |   |   |   |       | |   |   |         |   | |
+-+-+-+-+-+ +-+-+-+-+-+-+ + +-+ + + + + +-+ +-+-+ +-+ + + +-+-+-+ +-+-+-+-+-+-+ +
|           |   |   |   | |     | | | | | | |     | | |   |   | | | |           |
+ + +-+-+-+-+ + + + + + +-+-+-+-+ + + + + + + + +-+ + +-+-+ + + + + + +-+-+-+-+-+
| |   | |     |   |   |       |   | |       | | |   |   |   | |   | | |         |
+-+-+ + + +-+-+-+-+-+-+-+-+-+ + +-+ +-+-+-+-+ + + +-+-+ +-+-+ +-+-+ + + +-+-+-+ +
|     | |       | |         |   |   |     |   | |           | |     |   |       |
+ +-+-+ +-+-+-+ + + +-+-+-+ +-+-+ +-+ +-+-+ +-+ +-+-+ + +-+ + + +-+-+-+-+ +-+-+ +
| |     |       | |     |   |     |   |     | | |   | | | |   | |   |     |   | |
+ + +-+ + +-+-+-+ +-+ + + +-+ +-+-+ +-+-+ +-+ + + + +-+ + +-+-+ + + + +-+-+ + + +
|   |   | |     |   | | |   |     |       | |   | | |   |   | |   | |   |   | | |
+-+-+ +-+ + +-+ +-+ + +-+-+ +-+-+-+-+-+ +-+ +-+-+ + + +-+-+ + +-+ + +-+ +-+-+ + +
|     |       |   |   |   |         |   |   | |   | | |   |   | | |   |   |   | |
+ +-+-+-+-+-+ +-+ +-+-+ + +-+-+-+-+ + + +-+ + + + + + + + + +-+ + + +-+-+ + +-+ +
|               |       |         |   |     |   | |     |   |     |         |    
+-+-+-+-+-+-+-+-+-+-+-+-+-+-+-+-+-+-+-+-+-+-+-+-+-+-+-+-+-+-+-+-+-+-+-+-+-+-+-+-+
