+-+-+-+-+-+-+-+-+-+-+-+-+-+-+-+-+-+-+-+-+
  |     |       |     |       |         |
+ + + +-+ +-+-+ + +-+ + +-+-+ + +-+-+-+ +
| | | |   |       |   | |     |   | |   |
+ + + + +-+ +-+-+-+-+-+ + +-+-+-+ + + +-+
|   | |   |         |   |   |   |   |   |
+-+-+ +-+ +-+-+-+-+ + +-+-+-+ + +-+-+-+ +
|   |   | |     | | | | |     | | |     |
+ + +-+ + + +-+ + + + + + +-+-+ + + +-+-+
| |   | |   | | |   |     |   |   |     |
+ +-+ + +-+-+ + +-+-+-+ +-+ +-+-+ +-+ + +
|   |   |         |   |   |       |   | |
+-+ +-+-+ +-+-+ + + + +-+-+-+ +-+-+-+-+ +
| |       |     |   |       |   |   |   |
+ +-+-+-+-+ + +-+-+ +-+-+ + +-+ + + + +-+
|   |   |   | |     |     |     | | | | |
+ + + + +-+-+ +-+-+-+ + +-+-+-+-+ +-+ + +
| | | |   |   |   |   | |   |     |   | |
+ + + +-+ +-+ + + + +-+-+ + + +-+-+ +-+ +
| | | | |     | | |   |   | |     | | | |
+ +-+ + +-+-+ +-+ +-+-+ +-+ +-+-+ + + + +
| |   | |         |   |   |     | | |   |
+ + +-+ +-+-+ +-+-+ + +-+ +-+-+ + + +-+ +
| |   |     | |   | | |   |       |   | |
+ +-+ +-+-+ +-+ + + + +-+-+-+ + +-+-+ + +
|   | |     |   | | |   | |   |   |   | |
+ + + + +-+-+ +-+ +-+-+ + + +-+-+ + +-+ +
| |   |       |   |   | | | |     |     |
+ +-+-+-+ +-+-+ +-+ + + + + + +-+-+ +-+-+
|         |         |       |            
+-+-+-+-+-+-+-+-+-+-+-+-+-+-+-+-+-+-+-+-+
